NO ./textures/wood.xpm
SO ./textures/grey.xpm
WE ./textures/brick.xpm
EA ./textures/blue.xpm
S ./textures/span44.xpm
H ./textures/shar_bzz.xpm

R 960 540

F 255,0,0
C 0,0,255


   1111 1111
   1001 1001    11111
   100111001    10001
 11100000001111110001
 10000000003000000001
 10002220000000200001
 10000200033333000001
 10000000030001111111
 10011100020001
 1111 100000001
      100000001 11111
111111100020001 10001
100000000000001 10001
100000000030001 10001
100111111100001 10201
1001     100001 10001
1001111  100001110001
1000001  100000000001
1002001  100000200001
100N001  100000200001
1111111  111111111111
